"COMPANY"	"Company name"
"TICKER"	"Ticker"
"EXCHG_DESC"	"Exchange"
"BUSINESS"	"Business"
"SMG_DESC"	"Sector"
"IMG_DESC"	"Industry"
"SIC"	"SIC primary code"
"ADR"	"ADR/ADS Stock"
"DOW_DESC"	"Dow stock"
"SP_DESC"	"Standard and Poor stock"
"DRP_AVAIL"	"Provides DRP plan"
"STREET"	"Street"
"CITY"	"City"
"STATE"	"State"
"COUNTRY"	"Country"
"ZIP"	"Zip"
"PHONE"	"Phone"
"WEB_ADDR"	"Web address"
"ANALYST_FN"	"Analyst's footnotes"
"EMPLOYEES"	"Number of employees"
